"filename", "language", "HTML", "JavaScript", "comment", "blank", "total"
"d:\CCC\3rd Year\2nd Sem\Capstone\City Housing and Settlements Department Website\CHSD-MIS\ClientPages\applicationproto.html", "HTML", 273, 0, 12, 31, 316
"d:\CCC\3rd Year\2nd Sem\Capstone\City Housing and Settlements Department Website\CHSD-MIS\ClientPages\clientApplication.html", "HTML", 260, 0, 12, 55, 327
"d:\CCC\3rd Year\2nd Sem\Capstone\City Housing and Settlements Department Website\CHSD-MIS\ClientPages\clientBuildingPermit.html", "HTML", 1335, 0, 25, 243, 1603
"d:\CCC\3rd Year\2nd Sem\Capstone\City Housing and Settlements Department Website\CHSD-MIS\ClientPages\clientDashboard.html", "HTML", 469, 0, 17, 88, 574
"d:\CCC\3rd Year\2nd Sem\Capstone\City Housing and Settlements Department Website\CHSD-MIS\ClientPages\clientElectricalApplication.html", "HTML", 735, 0, 15, 106, 856
"d:\CCC\3rd Year\2nd Sem\Capstone\City Housing and Settlements Department Website\CHSD-MIS\ClientPages\clientHousingApplication.html", "HTML", 1420, 0, 16, 256, 1692
"d:\CCC\3rd Year\2nd Sem\Capstone\City Housing and Settlements Department Website\CHSD-MIS\ClientPages\clientLogin.html", "HTML", 214, 0, 1, 29, 244
"d:\CCC\3rd Year\2nd Sem\Capstone\City Housing and Settlements Department Website\CHSD-MIS\ClientPages\clientNotif.html", "HTML", 219, 0, 10, 40, 269
"d:\CCC\3rd Year\2nd Sem\Capstone\City Housing and Settlements Department Website\CHSD-MIS\ClientPages\clientOccupancyApplication.html", "HTML", 865, 0, 16, 135, 1016
"d:\CCC\3rd Year\2nd Sem\Capstone\City Housing and Settlements Department Website\CHSD-MIS\ClientPages\clientProfile.html", "HTML", 108, 0, 2, 18, 128
"d:\CCC\3rd Year\2nd Sem\Capstone\City Housing and Settlements Department Website\CHSD-MIS\ClientPages\clientRequirements.html", "HTML", 568, 0, 12, 62, 642
"d:\CCC\3rd Year\2nd Sem\Capstone\City Housing and Settlements Department Website\CHSD-MIS\ClientPages\clientSignup.html", "HTML", 542, 0, 9, 93, 644
"d:\CCC\3rd Year\2nd Sem\Capstone\City Housing and Settlements Department Website\CHSD-MIS\ClientPages\nav2.html", "HTML", 51, 0, 5, 7, 63
"d:\CCC\3rd Year\2nd Sem\Capstone\City Housing and Settlements Department Website\CHSD-MIS\ClientPages\nav2.js", "JavaScript", 0, 8, 0, 0, 8
"d:\CCC\3rd Year\2nd Sem\Capstone\City Housing and Settlements Department Website\CHSD-MIS\ClientPages\nav3.html", "HTML", 42, 0, 5, 5, 52
"d:\CCC\3rd Year\2nd Sem\Capstone\City Housing and Settlements Department Website\CHSD-MIS\ClientPages\nav3.js", "JavaScript", 0, 8, 0, 0, 8
"d:\CCC\3rd Year\2nd Sem\Capstone\City Housing and Settlements Department Website\CHSD-MIS\ClientPages\navBarScript.js", "JavaScript", 0, 0, 0, 1, 1
"d:\CCC\3rd Year\2nd Sem\Capstone\City Housing and Settlements Department Website\CHSD-MIS\ClientPages\profileBackup.html", "HTML", 201, 0, 2, 19, 222
"Total", "-", 7302, 16, 159, 1188, 8665