"filename", "language", "HTML", "JavaScript", "comment", "blank", "total"
"d:\CCC\3rd Year\2nd Sem\Capstone\City Housing and Settlements Department Website\CHSD-MIS\ClientPages\applicationproto.html", "HTML", 273, 0, 12, 31, 316
"d:\CCC\3rd Year\2nd Sem\Capstone\City Housing and Settlements Department Website\CHSD-MIS\ClientPages\clientApplication.html", "HTML", 274, 0, 12, 57, 343
"d:\CCC\3rd Year\2nd Sem\Capstone\City Housing and Settlements Department Website\CHSD-MIS\ClientPages\clientBuildingPermit.html", "HTML", 1438, 0, 27, 265, 1730
"d:\CCC\3rd Year\2nd Sem\Capstone\City Housing and Settlements Department Website\CHSD-MIS\ClientPages\clientDashboard.html", "HTML", 547, 0, 19, 102, 668
"d:\CCC\3rd Year\2nd Sem\Capstone\City Housing and Settlements Department Website\CHSD-MIS\ClientPages\clientElectricalApplication.html", "HTML", 974, 0, 19, 155, 1148
"d:\CCC\3rd Year\2nd Sem\Capstone\City Housing and Settlements Department Website\CHSD-MIS\ClientPages\clientHousingApplication.html", "HTML", 1316, 0, 16, 282, 1614
"d:\CCC\3rd Year\2nd Sem\Capstone\City Housing and Settlements Department Website\CHSD-MIS\ClientPages\clientLogin.html", "HTML", 269, 0, 1, 37, 307
"d:\CCC\3rd Year\2nd Sem\Capstone\City Housing and Settlements Department Website\CHSD-MIS\ClientPages\clientNotif.html", "HTML", 219, 0, 10, 40, 269
"d:\CCC\3rd Year\2nd Sem\Capstone\City Housing and Settlements Department Website\CHSD-MIS\ClientPages\clientOccupancyApplication.html", "HTML", 1329, 0, 21, 231, 1581
"d:\CCC\3rd Year\2nd Sem\Capstone\City Housing and Settlements Department Website\CHSD-MIS\ClientPages\clientProfile.html", "HTML", 422, 0, 13, 59, 494
"d:\CCC\3rd Year\2nd Sem\Capstone\City Housing and Settlements Department Website\CHSD-MIS\ClientPages\clientRequirements.html", "HTML", 572, 0, 12, 62, 646
"d:\CCC\3rd Year\2nd Sem\Capstone\City Housing and Settlements Department Website\CHSD-MIS\ClientPages\clientSignup.html", "HTML", 729, 0, 14, 110, 853
"d:\CCC\3rd Year\2nd Sem\Capstone\City Housing and Settlements Department Website\CHSD-MIS\ClientPages\nav2.html", "HTML", 51, 0, 5, 7, 63
"d:\CCC\3rd Year\2nd Sem\Capstone\City Housing and Settlements Department Website\CHSD-MIS\ClientPages\nav2.js", "JavaScript", 0, 8, 0, 0, 8
"d:\CCC\3rd Year\2nd Sem\Capstone\City Housing and Settlements Department Website\CHSD-MIS\ClientPages\nav3.html", "HTML", 42, 0, 5, 5, 52
"d:\CCC\3rd Year\2nd Sem\Capstone\City Housing and Settlements Department Website\CHSD-MIS\ClientPages\nav3.js", "JavaScript", 0, 8, 0, 0, 8
"d:\CCC\3rd Year\2nd Sem\Capstone\City Housing and Settlements Department Website\CHSD-MIS\ClientPages\navBarScript.js", "JavaScript", 0, 0, 0, 1, 1
"d:\CCC\3rd Year\2nd Sem\Capstone\City Housing and Settlements Department Website\CHSD-MIS\ClientPages\profileBackup.html", "HTML", 201, 0, 2, 19, 222
"Total", "-", 8656, 16, 188, 1463, 10323